34 40
8 5 1
0   0   0   0   0   0   0   0   0   0   0   0   0   0   0   0   0   0   0   0   0   0   0   0   0   0   0   0   0   0   0   0   0   0   0   0   0   0   0   0
0   0   0   0   0   0   0   0   0   0   0   0   0   0   0   0   0   0   0   0   0   0   0   0   0   0   0   0   0   0   0   0   0   0   0   0   0   0   0   0
0   0   0   0   0   0   0   0   255 0   0   0   0   0   0   0   0   0   0   0   0   0   0   0   0   0   0   0   0   0   0   0   0   0   0   0   0   0   0   0
0   0   0   0   0   0   0   0   255 0   0   0   0   0   0   0   0   0   0   0   0   0   0   0   0   0   0   0   0   0   0   0   0   0   0   0   0   0   0   0
0   0   0   0   0   0   0   0   255 0   0   0   0   0   0   0   0   0   255 255 255 255 0   0   0   0   0   0   0   0   0   0   0   0   0   0   0   255 0   0
0   0   0   0   0   255 255 255 255 255 255 0   0   0   0   0   0   0   0   0   0   255 0   0   0   0   0   0   0   0   0   0   0   0   0   0   0   255 0   0
0   0   0   0   0   255 0   0   0   0   255 0   0   0   255 255 255 0   0   0   0   255 0   0   0   0   0   0   0   0   0   0   0   0   255 255 255 255 0   0
0   0   0   0   0   255 0   0   0   0   255 0   0   0   255 0   0   0   0   0   0   255 0   0   0   0   0   0   0   0   0   0   0   0   255 0   0   0   0   0
0   0   0   0   0   255 0   0   0   0   255 0   0   0   255 0   0   0   0   0   0   255 0   0   0   0   0   0   0   0   0   0   0   0   255 0   0   0   0   0
0   0   0   0   255 255 255 0   0   0   255 255 255 255 255 255 255 255 255 255 255 255 255 255 255 255 255 255 255 255 255 255 255 255 255 0   0   0   0   0
0   0   0   0   255 255 255 0   0   0   0   0   0   0   0   0   0   0   0   255 0   0   0   0   0   0   0   0   0   0   0   0   0   0   255 0   0   0   0   0
0   0   0   0   255 255 255 0   0   0   0   0   0   0   0   0   0   0   0   255 0   0   0   0   0   0   0   0   0   0   0   0   0   0   255 0   0   0   0   0
0   0   0   0   0   255 0   0   0   0   0   0   0   0   0   0   0   0   0   255 0   0   0   0   0   0   0   0   0   0   0   0   0   0   255 0   0   0   0   0
0   0   0   0   0   255 0   0   0   0   0   0   0   0   0   0   0   0   0   255 0   0   0   0   0   0   0   0   0   0   0   0   0   0   255 255 255 255 0   0
0   0   0   0   0   255 0   0   0   0   0   0   0   0   255 255 255 255 255 255 0   0   0   0   0   0   0   0   0   0   255 0   0   0   255 0   0   0   0   0
0   0   0   0   0   255 0   0   0   0   0   0   0   0   0   0   0   0   0   0   0   0   0   0   0   0   0   0   0   0   255 0   0   0   255 0   0   0   0   0
0   0   0   0   0   255 0   0   0   0   255 0   0   0   0   0   0   0   0   0   0   0   0   0   0   0   0   0   0   0   255 0   0   0   255 0   0   0   0   0
0   0   0   0   0   255 0   0   0   0   255 0   0   0   0   0   0   0   0   0   0   0   0   0   0   0   0   0   0   0   255 0   0   0   255 0   0   0   0   0
0   0   0   0   0   255 0   0   0   0   255 0   0   0   0   0   0   0   0   0   0   0   0   0   0   0   0   0   0   0   255 0   0   0   255 0   0   0   0   0
0   0   0   0   0   255 255 255 255 255 255 0   0   0   0   0   0   0   0   0   0   0   0   0   0   0   0   0   0   0   255 0   0   0   255 0   0   0   0   0
0   0   0   0   0   255 0   0   0   0   0   0   0   0   0   0   0   0   0   0   0   0   0   0   0   0   0   0   0   0   255 255 255 255 255 0   0   0   0   0
0   0   0   0   0   255 0   0   0   0   0   0   0   0   0   0   0   0   0   0   0   0   0   0   0   0   0   0   0   0   0   0   0   0   255 0   0   0   0   0
0   0   0   0   0   255 0   0   0   0   0   0   0   0   0   0   0   0   0   0   0   0   0   0   0   0   0   0   0   0   0   0   0   0   255 0   0   0   0   0
0   0   0   0   0   255 0   0   0   0   0   0   0   0   0   0   0   0   0   0   0   0   0   0   0   0   0   0   0   0   0   0   0   0   255 0   0   0   0   0
0   0   0   0   0   255 255 255 255 255 255 255 255 255 255 255 255 255 255 255 255 255 255 255 255 255 0   0   0   0   0   0   0   0   255 0   0   0   0   0
0   0   0   0   0   0   0   0   0   255 0   0   0   0   0   0   0   0   0   0   0   0   255 0   0   255 0   0   0   0   0   0   0   0   255 255 255 255 0   0
0   0   0   0   0   0   0   0   0   255 0   0   0   0   0   0   0   0   0   0   0   0   255 0   0   255 0   0   0   0   0   0   0   0   255 0   0   0   0   0
0   0   0   0   0   0   0   0   0   255 0   0   0   0   0   0   0   0   0   0   255 255 255 0   0   255 0   0   0   0   0   0   0   0   255 0   0   0   0   0
0   0   0   0   0   0   0   0   0   255 0   0   0   0   0   0   0   0   0   0   0   0   0   0   0   255 255 255 255 255 255 255 255 255 255 0   0   0   0   0
0   0   0   0   0   0   0   0   0   255 255 255 255 255 0   0   0   0   0   0   0   0   0   0   0   0   0   0   0   0   0   255 0   0   0   0   0   0   0   0
0   0   0   0   0   0   0   0   0   0   0   0   0   0   0   0   0   0   0   0   0   0   0   0   0   0   0   0   0   0   0   255 0   0   0   0   0   0   0   0
0   0   0   0   0   0   0   0   0   0   0   0   0   0   0   0   0   0   0   0   0   0   0   0   0   0   0   0   0   0   0   255 0   0   0   0   0   0   0   0
0   0   0   0   0   0   0   0   0   0   0   0   0   0   0   0   0   0   0   0   0   0   0   0   0   0   0   0   0   0   0   0   0   0   0   0   0   0   0   0
0   0   0   0   0   0   0   0   0   0   0   0   0   0   0   0   0   0   0   0   0   0   0   0   0   0   0   0   0   0   0   0   0   0   0   0   0   0   0   0
