30 40
26 15 2
0   0   0   0   0   0   0   0   0   0   0   0   0   0   0   0   0   0   0   0   0   0   0   0   0   0   0   0   0   0   0   0   0   0   0   0   0   0   0   0
0   0   0   0   0   0   0   0   0   0   0   0   0   0   0   0   0   0   255 255 255 0   0   0   0   0   0   0   0   0   0   0   0   0   0   0   0   0   0   0
0   0   0   0   0   0   0   0   0   0   0   0   0   0   0   0   0   0   255 0   255 0   0   0   0   0   0   0   0   0   0   0   0   0   0   0   0   0   0   0
0   0   0   0   0   255 255 255 255 255 255 255 255 255 0   0   0   0   255 0   255 0   0   255 0   0   0   0   0   0   0   0   0   0   0   0   0   0   0   0
0   0   0   0   0   255 0   0   0   0   0   0   0   255 0   0   0   0   255 0   255 0   0   255 0   0   0   0   0   0   255 0   0   0   0   0   0   0   0   0
0   0   0   255 255 255 0   0   0   0   0   0   0   255 0   0   0   0   255 0   255 255 255 255 0   0   0   0   0   0   255 0   0   0   0   0   0   0   0   0
0   0   0   0   0   255 0   0   0   0   0   0   0   255 255 255 255 255 255 0   255 0   0   0   0   0   0   0   0   0   255 0   0   0   255 255 255 0   0   0
0   0   0   0   0   255 255 255 255 255 0   0   0   0   0   0   255 0   0   0   255 0   0   0   0   0   0   0   0   0   255 0   0   0   0   0   255 0   0   0
0   0   0   0   0   0   0   0   0   255 0   0   0   0   0   0   255 0   0   0   255 255 255 255 255 0   0   0   0   0   255 0   0   0   0   0   255 0   0   0
0   0   0   0   0   0   0   0   0   255 0   0   0   0   0   0   255 0   0   0   0   0   0   0   255 0   0   0   0   0   255 0   0   0   0   0   255 0   0   0
0   0   0   0   0   0   255 255 255 255 0   0   0   0   255 255 255 0   0   0   0   0   0   0   255 255 255 255 255 255 255 255 255 255 0   0   255 0   0   0
0   0   0   0   0   0   255 0   0   0   0   0   0   0   0   0   0   0   0   0   0   0   0   0   0   0   0   0   0   0   0   0   0   255 0   0   255 0   0   0
0   0   0   0   0   0   255 0   0   0   0   0   0   0   0   0   0   0   0   0   0   0   0   0   0   0   0   0   0   0   0   0   0   255 0   0   255 0   0   0
0   0   0   0   255 255 255 0   0   0   255 255 255 255 255 0   0   0   0   0   0   0   0   0   0   0   0   0   0   0   255 255 255 255 255 255 255 0   0   0
0   0   0   0   0   0   255 0   0   0   255 0   0   0   0   0   0   0   0   0   0   0   0   0   0   0   0   0   0   0   255 0   0   0   0   0   0   0   0   0
0   0   0   0   0   0   255 0   0   0   255 0   0   0   0   0   0   0   0   0   0   0   0   0   0   0   0   0   0   0   255 0   0   0   0   0   0   0   0   0
0   0   0   0   0   0   255 0   0   0   255 0   0   0   0   0   0   0   0   0   255 255 255 255 0   0   0   0   0   0   255 0   0   0   0   0   0   0   0   0
0   0   0   0   0   0   255 255 255 255 255 255 255 255 255 0   0   0   0   0   0   0   0   255 0   0   0   0   0   0   255 0   0   0   0   0   0   0   0   0
0   0   0   0   0   0   255 0   0   0   0   0   0   0   255 0   0   0   0   0   0   0   0   255 0   0   0   255 255 255 255 255 255 255 0   0   0   0   0   0
0   0   0   0   0   0   255 0   0   0   0   0   0   0   255 0   0   255 255 255 255 0   0   255 0   0   0   255 0   0   0   0   0   0   0   0   0   0   0   0
0   0   0   0   0   0   255 0   0   255 255 255 0   0   255 0   0   255 0   0   255 0   0   255 0   0   0   255 0   0   0   0   0   0   0   0   0   0   0   0
0   0   0   0   255 255 255 0   0   255 0   0   0   0   255 0   0   255 0   0   255 0   0   255 0   0   0   255 0   0   0   0   0   0   0   0   0   0   0   0
0   0   0   0   0   0   0   0   0   255 0   0   255 255 255 0   0   255 255 0   255 255 255 255 255 255 0   255 255 255 255 255 0   0   0   0   0   0   0   0
0   0   0   0   0   0   0   0   0   255 0   0   255 0   0   0   0   255 0   0   0   0   0   0   0   255 0   0   0   0   0   255 0   0   0   0   0   0   0   0
0   0   0   0   0   0   0   0   0   255 255 255 255 0   0   0   0   255 0   0   0   0   255 255 255 255 0   0   0   0   0   255 0   0   0   0   0   0   0   0
0   0   0   0   0   0   0   0   0   0   0   0   255 0   0   0   255 255 255 0   0   0   255 0   0   255 0   0   0   0   0   255 0   0   0   0   0   0   0   0
0   0   0   0   0   0   0   0   0   0   0   0   255 255 255 255 255 255 255 0   0   0   255 0   0   255 255 255 255 255 255 255 0   0   0   0   0   0   0   0
0   0   0   0   0   0   0   0   0   0   0   0   0   0   0   0   255 255 255 0   0   0   0   0   0   0   0   0   0   0   0   0   0   0   0   0   0   0   0   0
0   0   0   0   0   0   0   0   0   0   0   0   0   0   0   0   0   0   0   0   0   0   0   0   0   0   0   0   0   0   0   0   0   0   0   0   0   0   0   0
0   0   0   0   0   0   0   0   0   0   0   0   0   0   0   0   0   0   0   0   0   0   0   0   0   0   0   0   0   0   0   0   0   0   0   0   0   0   0   0
